{
  "center": { "x": 1024, "y": 1024 },
  "targets": [
    { "x":  220, "y": 1050 },
    { "x":  228, "y": 1282 },
    { "x":  190, "y": 1308 },
    { "x":  225, "y": 1800 },
    { "x":  218, "y": 1893 },
    { "x":  114, "y": 1993 },
    { "x":  358, "y": 1050 },
    { "x":  380, "y": 1150 },
    { "x":  423, "y": 1297 },
    { "x":  384, "y": 1408 },
    { "x":  384, "y": 1664 },
    { "x":  413, "y": 1842 },
    { "x":  648, "y": 1930 },
    { "x":  305, "y": 2003 },
    { "x": 1024, "y": 1024 }
  ]
}